NO images/walls/blue_bamboo.png
SO images/walls/walls_later.png




WE images/walls/windoooow.png
EA images/walls/wall_fish.png


C 0,185,209
F 213,220,170


11111111111111111111111111111111
10011100000000000000000000000001
10010100100000000000000000000001
1111D1111111D1111111111111111111
1011010010100010010100000D001001
100D0000D00000100D0000000100D001
1111D111111111111111111111D11101
10000100100000000000000000000001
10000100100000000000000000000001
1D1111D11111111111111111111111D1
100D0000D000D000D0000D0000D00001
11111D1111D111111111111111111D11
10010000100000100001000001001001
110D0000D0000010000D00000D00D001
1111D1111111D11111111D1111111111
10000000000000000000000000000001
10000000000000000000000000000001
10001000100000000000000000000001
111111D1111111111111111111111111
100D0000D000D000D0000D0000D00001
1D11111111D111111111111111111D11
10010000100000100001000001001001
110D0000D0000010000D00000D00D001
1111D1111111D11111111D1111111111
10000000000000000000000000000001
10000000000000000000000000000N01
11111111111111111111111111111111
