NO images/walls/squid_game/neon-circle.png
SO images/walls/squid_game/star_neon.png




WE images/walls/squid_game/neon-triangle.png
EA images/walls/squid_game/neon-square.png
C 255,255,255
F 221,48,137






                       111111111111
                        10000000001
                        10000000001
                         100000001
1111111111111111111111111111000001
100000000000000000000000000000001
11011111111011111111101111000001
10011    110000000000000001111111
10011    111111111111111101                           111111
110111111110000000000000001                          10000001
10001000011011111111111111111111111111111           1000000001
1000000001101               1000000000001          100000000001
1000100001101               100000000000111111111110000000000001
100011111110111111          100001011000000000000000000000000001
100011000000000001          100001000000111111111110000000000001
100011000000000001          1000010010001          100000000001
10001100000000000111111111111000000000001           1000000001
10001100000100000000000000000000011111111            10000001
1000110000100000011111111111110001                    111111
100001000000000001           10001
100000000000000101           10001
100001000000000001           10001
100011000001000001           10001
100011000000000001          10001
100011000000000001         10001
100011000000000001        10001
100011111111111111       10001
10001            111111 10001
1001          11100000010001
101         110000000000001
101        10000000000000001
101       1000000000000000001
101111111100000000000000000001
10000000000000000000E000000001
111111111100000000000000000001
          1000000000000000001
           10000000000000001
            110000000000011
              11100000111
                 11111
