NO images/walls/blue_bamboo.png
SO images/walls/walls_later.png

WE images/walls/windoooow.png
EA images/walls/wall_fish.png

C 0,185,209
F 213,220,170

11111111111111111111111111111111
10011100000000000000000000000001
10010100100000000000000000000001
11110111111101111111111111111111
10110100101000100101000000001001
10000000000000100000000001000001
11110111111111111111111111011101
10000100100000000000000000000001
10000100100000000000000000000001
10111101111111111111111111111101
10000000000000000000000000000001
11111011110111111111111111111011
10010000100000100001000001001001
11000000000000100000000000000001
11110111111101111111101111111111
10000000000000000000000000000001
10000000000000000000000000000001
10001000100000000000000000000001
11111101111111111111111111111111
10000000000000000000000000000001
10111111110111111111111111111011
10010000100000100001000001001001
11000000000000100000000000000001
11110111111101111111101111111111
10000000000000000000000000000001
10000000000000000000000000000N01
11111111111111111111111111111111